,Nat,Skater,JGP,CS,GP,Ch,WD,MeanEventTotal,nmean,MeanEventBV,nBV,MeanEventTES,nTES,MeanEventPCS,nPCS,MeanJump,nJump,MeanSpin,nSpin,MeanStep Seq,nstepseq,MeanChor Seq,nchorseq,MeanSS,nSS,MeanTR,NTR,MeanPE,nPE,MeanCO,nCO,MeanIN,nIN
0,ðŸ‡·ðŸ‡º,Kamila Valieva,0,1,2,1,0,261.52,4,119.54,4,150.75,4,111.52,4,10.63,40,4.76,24,5.54,8,4.81,4,9.28,8,9.09,8,9.32,8,9.34,8,9.36,8
1,ðŸ‡·ðŸ‡º,Anna Shcherbakova,0,0,2,1,0,234.63,3,102.99,3,126.51,3,108.79,3,8.53,30,4.33,18,5.3,6,4.6,3,8.98,6,8.89,6,9.06,6,9.13,6,9.14,6
2,ðŸ‡·ðŸ‡º,Alexandra Trusova,0,0,1,1,0,233.36,2,113.15,2,130.5,2,104.36,2,9.18,20,4.18,12,4.69,4,4.25,2,8.8,4,8.51,4,8.75,4,8.78,4,8.73,4
3,ðŸ‡·ðŸ‡º,Elizaveta Tuktamysheva,0,1,2,0,0,231.8,3,104.62,3,124.58,3,107.22,3,8.56,30,4.05,18,4.97,6,4.72,3,8.76,6,8.54,6,9.13,6,9,6,9.19,6
4,ðŸ‡·ðŸ‡º,Sofia Akateva,2,0,0,0,0,229.36,2,117.3,2,137.11,2,92.75,2,10.08,20,4.31,12,5.2,4,Null,0,7.8,4,7.51,4,7.88,4,7.73,4,7.8,4
5,ðŸ‡¯ðŸ‡µ,Kaori Sakamoto,0,0,2,0,0,219.64,2,92.44,2,113.38,2,106.25,2,7.5,20,3.99,12,5.02,4,4.4,2,9,4,8.61,4,8.93,4,8.84,4,8.84,4
6,ðŸ‡·ðŸ‡º,Alena Kostornaia,0,1,2,0,0,218.41,3,99.43,3,114.81,3,103.93,3,7.72,30,4.19,18,4.22,6,4.08,3,8.78,6,8.46,6,8.75,6,8.7,6,8.74,6
7,ðŸ‡·ðŸ‡º,Daria Usacheva,0,0,1,0,0,217.31,1,93.61,1,113.29,1,104.02,1,7.21,10,4.36,6,5.18,2,4.71,1,8.61,2,8.48,2,8.76,2,8.68,2,8.73,2
8,ðŸ‡·ðŸ‡º,Veronika Zhilina,1,0,0,0,0,216.92,1,106.15,1,123.94,1,93.98,1,9.2,10,4.05,6,3.81,2,Null,0,7.88,2,7.66,2,7.86,2,7.76,2,7.91,2
9,ðŸ‡¯ðŸ‡µ,Mai Mihara,0,0,2,1,0,214.33,3,95.13,3,115.11,3,99.22,3,7.69,30,3.96,18,4.99,6,4.52,3,8.19,6,8,6,8.33,6,8.24,6,8.24,6
10,ðŸ‡·ðŸ‡º,Maiia Khromykh,0,1,2,0,0,213.35,3,100.63,3,114.2,3,100.16,3,7.65,30,4.18,18,4.12,6,4.37,3,8.34,6,8.21,6,8.27,6,8.42,6,8.39,6
11,ðŸ‡§ðŸ‡ª,Loena Hendrickx,0,1,2,1,0,210.7,4,90.84,4,107.93,4,103.26,4,6.72,40,4.23,24,5.33,8,4.63,4,8.46,8,8.36,8,8.6,8,8.68,8,8.69,8
12,ðŸ‡·ðŸ‡º,Sofia Muravieva,2,0,0,0,0,210.03,2,92.04,2,113.91,2,96.12,2,7.94,20,4.06,12,5.09,4,Null,0,7.97,4,7.78,4,8.05,4,7.92,4,8.14,4
13,ðŸ‡ºðŸ‡¸,Alysa Liu,0,2,2,0,0,209.02,4,97.68,4,109.12,4,100.4,4,6.95,40,4.21,24,4.95,8,4.41,4,8.3,8,8.16,8,8.4,8,8.41,8,8.42,8
14,ðŸ‡·ðŸ‡º,Adeliia Petrosian,2,0,0,0,0,205.89,2,97.28,2,114.04,2,91.85,2,8.1,20,4.11,12,4.22,4,Null,0,7.7,4,7.51,4,7.76,4,7.58,4,7.67,4
15,ðŸ‡ºðŸ‡¸,Isabeau Levito,2,0,0,0,0,205.33,2,92.94,2,112.32,2,93,2,7.72,20,4.22,12,4.92,4,Null,0,7.62,4,7.59,4,7.8,4,7.72,4,7.92,4
16,ðŸ‡¯ðŸ‡µ,Satoko Miyahara,0,0,2,0,0,205.04,2,91.51,2,101.28,2,103.76,2,6.14,20,4.11,12,5.42,4,4.42,2,8.64,4,8.48,4,8.6,4,8.7,4,8.72,4
17,ðŸ‡·ðŸ‡º,Sofia Samodelkina,2,0,0,0,0,204.03,2,102.95,2,114.06,2,90.96,2,8.05,20,3.98,12,4.84,4,Null,0,7.68,4,7.26,4,7.6,4,7.58,4,7.72,4
18,ðŸ‡·ðŸ‡º,Ksenia Sinitsina,0,0,2,0,0,202.26,2,94.33,2,106.94,2,95.32,2,7.14,20,3.87,12,4.04,4,4.28,2,7.89,4,7.75,4,8,4,7.96,4,8.01,4
19,ðŸ‡°ðŸ‡·,Yelim Kim,0,0,2,1,0,200.92,3,90.1,3,104.45,3,97.14,3,6.89,30,3.81,18,4.36,6,4,3,8.18,6,7.86,6,8.14,6,8.11,6,8.08,6
20,ðŸ‡ºðŸ‡¸,Mariah Bell,0,0,2,0,0,200.57,2,87.76,2,102.03,2,99.04,2,6.47,20,3.91,12,4.6,4,4.64,2,8.15,4,7.99,4,8.23,4,8.24,4,8.35,4
21,ðŸ‡¯ðŸ‡µ,Wakaba Higuchi,0,1,2,0,0,199.87,3,91.75,3,101.61,3,98.93,3,6.35,30,3.97,18,4.91,6,4.43,3,8.31,6,8,6,8.2,6,8.3,6,8.39,6
22,ðŸ‡°ðŸ‡·,Young You,0,1,2,1,0,199.84,4,96.2,4,103.64,4,97.7,4,6.74,40,3.83,24,4.34,8,4.57,4,8.26,8,7.88,8,8.12,8,8.17,8,8.13,8
23,ðŸ‡·ðŸ‡º,Anastasia Zinina,2,0,0,0,0,198.43,2,99,2,111.1,2,88.82,2,7.84,20,4.02,12,4.3,4,Null,0,7.43,4,7.17,4,7.45,4,7.42,4,7.48,4
24,ðŸ‡·ðŸ‡º,Elizaveta Berestovskaya,1,0,0,0,0,196.07,1,95.73,1,107.61,1,88.46,1,7.26,10,4.28,6,4.66,2,Null,0,7.27,2,7.12,2,7.42,2,7.39,2,7.43,2
25,ðŸ‡¯ðŸ‡µ,Mana Kawabe,0,0,2,0,0,195.98,2,95.08,2,102.92,2,94.56,2,6.98,20,3.58,12,3.61,4,4.43,2,7.95,4,7.64,4,7.82,4,7.83,4,7.77,4
26,ðŸ‡°ðŸ‡·,Minchae Kim,1,0,0,0,0,192.48,1,88.08,1,103.65,1,88.83,1,7.39,10,3.4,6,4.66,2,Null,0,7.59,2,7.2,2,7.45,2,7.45,2,7.42,2
27,ðŸ‡¬ðŸ‡ª,Anastasiia Gubanova,0,2,0,1,0,192.12,3,88.26,3,100.32,3,92.47,3,6.58,30,3.68,18,4.39,6,3.66,3,7.64,6,7.4,6,7.71,6,7.71,6,7.82,6
28,ðŸ‡°ðŸ‡·,Haein Lee,0,0,2,1,0,191.61,3,89.85,3,97.49,3,94.79,3,6.23,30,3.62,18,4.48,6,4.55,3,7.94,6,7.7,6,7.89,6,7.96,6,7.98,6
29,ðŸ‡¯ðŸ‡µ,Rino Matsuike,0,0,2,1,0,190.91,3,86.56,3,97.54,3,94.04,3,6.16,30,3.93,18,3.98,6,4.41,3,7.83,6,7.61,6,7.8,6,7.86,6,7.84,6
30,ðŸ‡·ðŸ‡º,Mariia Zakharova,1,0,0,0,0,190.33,1,96.32,1,104.29,1,87.04,1,7.29,10,3.88,6,4.06,2,Null,0,7.45,2,7.12,2,7.34,2,7.27,2,7.38,2
31,ðŸ‡·ðŸ‡º,Elizaveta Kulikova,2,0,0,0,0,190.14,2,90.52,2,104.65,2,85.98,2,7.13,20,4.09,12,4.41,4,Null,0,7.04,4,6.96,4,7.25,4,7.18,4,7.2,4
32,ðŸ‡°ðŸ‡·,Chaeyeon Kim,2,0,0,0,0,189.96,2,89.58,2,104.98,2,85.48,2,7.19,20,4.06,12,4.34,4,Null,0,7.25,4,7,4,7.11,4,7.04,4,7.02,4
33,ðŸ‡µðŸ‡±,Ekaterina Kurakova,0,3,2,1,0,189.67,6,90.6,6,98.49,6,91.18,6,6.18,60,3.84,36,4.82,12,3.98,6,7.47,12,7.27,12,7.61,12,7.61,12,7.69,12
34,ðŸ‡ºðŸ‡¸,Karen Chen,0,2,2,0,0,188.22,4,83.08,4,89.73,4,99.74,4,5.09,40,4.15,24,4.62,8,4.65,4,8.36,8,8.17,8,8.21,8,8.46,8,8.44,8
35,ðŸ‡§ðŸ‡¾,Viktoriia Safonova,0,3,1,1,0,187.85,5,92.59,5,100.97,5,87.07,5,6.77,50,3.7,30,3.7,10,3.67,5,7.29,10,7.08,10,7.26,10,7.32,10,7.23,10
36,ðŸ‡¨ðŸ‡¦,Madeline Schizas,0,1,2,0,0,187.81,3,88.31,3,97.76,3,90.05,3,6.32,30,3.83,18,3.65,6,4.31,3,7.47,6,7.27,6,7.54,6,7.56,6,7.53,6
37,ðŸ‡ºðŸ‡¸,Lindsay Thorngren,2,1,0,0,0,186.54,3,91.73,3,101.21,3,85.67,3,6.79,30,3.99,18,4,6,4.1,1,7.25,6,6.96,6,7.07,6,7.15,6,7.03,6
38,ðŸ‡ºðŸ‡¸,Amber Glenn,0,2,2,0,0,185.92,4,81.13,4,91.28,4,94.88,4,5.72,40,3.51,24,4.31,8,4.47,4,8.01,8,7.61,8,7.88,8,7.93,8,7.94,8
39,ðŸ‡°ðŸ‡·,Yeonjeong Park,0,1,1,0,0,185.09,2,89.5,2,95.81,2,90.78,2,5.97,20,4.01,12,4.09,4,3.84,2,7.6,4,7.3,4,7.49,4,7.57,4,7.57,4
40,ðŸ‡¦ðŸ‡¿,Ekaterina Ryabova,0,1,2,1,0,184.54,4,90.92,4,97.37,4,87.42,4,6.4,40,3.66,24,3.82,8,3.83,4,7.36,8,7.1,8,7.36,8,7.3,8,7.32,8
41,ðŸ‡°ðŸ‡·,Eunsoo Lim,0,0,2,0,0,183.13,2,82.8,2,90.12,2,94,2,5.94,19,3.57,12,4.33,4,3.61,2,8.06,4,7.7,4,7.77,4,7.92,4,7.9,4
42,ðŸ‡°ðŸ‡·,Jia Shin,2,0,0,0,0,181.03,2,88.51,2,99.59,2,82.44,2,6.67,20,3.89,12,4.79,4,Null,0,6.96,4,6.61,4,6.92,4,6.82,4,6.91,4
43,ðŸ‡·ðŸ‡º,Sofia Samodurova,0,0,1,0,0,180.59,1,83.84,1,93.36,1,87.23,1,6.03,10,3.6,6,4.08,2,3.29,1,7.41,2,7.07,2,7.24,2,7.38,2,7.43,2
44,ðŸ‡¯ðŸ‡µ,Yuhana Yokoi,0,0,2,1,0,178.78,3,86.18,3,90.93,3,88.52,3,5.88,30,3.52,18,3.37,6,4.21,3,7.48,6,7.05,6,7.4,6,7.36,6,7.44,6
45,ðŸ‡¨ðŸ‡¦,Kaiya Ruiter,2,0,0,0,0,178.76,2,89.95,2,95.5,2,83.76,2,6.45,20,3.73,12,4.31,4,Null,0,6.9,4,6.68,4,6.99,4,6.99,4,7.04,4
46,ðŸ‡ªðŸ‡ª,Niina PetrÃµkina,2,3,0,1,0,177.01,6,86.1,6,92.82,6,84.86,6,6.02,60,3.59,36,4.24,12,3.94,4,7.05,12,6.87,12,7.02,12,7.09,12,7.14,12
47,ðŸ‡ºðŸ‡¸,Audrey Shin,0,2,1,1,0,176.77,4,80.94,4,88.08,4,90.44,4,5.13,40,3.86,24,4.72,8,4.14,4,7.5,8,7.34,8,7.53,8,7.57,8,7.66,8
48,ðŸ‡¨ðŸ‡­,Alexia Paganini,0,2,0,1,0,176.69,3,83.1,3,89.67,3,87.69,3,5.75,30,3.45,18,3.84,6,3.81,3,7.36,6,7.03,6,7.36,6,7.34,6,7.37,6
49,ðŸ‡ºðŸ‡¸,Ava Marie Ziegler,2,0,0,0,0,175.58,2,85.79,2,91.15,2,84.43,2,6.31,20,3.3,12,4.1,4,Null,0,6.95,4,6.83,4,7.11,4,7.03,4,7.18,4
50,ðŸ‡ºðŸ‡¸,Clare Seo,2,0,0,0,0,174.83,2,88.12,2,92.34,2,83,2,6.11,20,3.72,12,4.46,4,Null,0,6.95,4,6.7,4,6.99,4,6.98,4,7.05,4
51,ðŸ‡§ðŸ‡ª,Nina Pinzarrone,2,0,0,0,0,174.59,2,90.96,2,96.73,2,78.36,2,6.45,20,4.08,12,3.86,4,Null,0,6.64,4,6.27,4,6.57,4,6.54,4,6.46,4
52,ðŸ‡°ðŸ‡·,Seoyeon Ji,2,1,0,0,0,172.1,3,87.42,3,93.11,3,78.99,3,6.54,30,3.32,18,3.36,6,3.2,1,6.78,6,6.24,6,6.64,6,6.53,6,6.45,6
53,ðŸ‡©ðŸ‡ª,Nicole Schott,0,2,2,1,0,171.53,5,78.74,5,84.91,5,87.02,5,5.27,50,3.55,30,3.68,10,3.6,5,7.33,10,7.03,10,7.24,10,7.35,10,7.35,10
54,ðŸ‡¨ðŸ‡³,Yi Zhu,0,0,1,0,0,171.25,1,79.86,1,87.38,1,84.87,1,5.22,10,3.81,6,4.32,2,3.64,1,7.23,2,6.8,2,7.09,2,7.1,2,7.02,2
55,ðŸ‡°ðŸ‡·,Seoyeong Wi,0,0,1,0,0,170.54,1,89.11,1,88.22,1,84.32,1,5.58,10,3.45,6,4.09,2,3.5,1,7.22,2,6.9,2,6.98,2,7.25,2,6.95,2
56,ðŸ‡ºðŸ‡¸,Kate Wang,2,0,0,0,0,170.33,2,85.57,2,93.74,2,76.58,2,6.67,20,3.19,12,3.93,4,Null,0,6.52,4,6.22,4,6.46,4,6.45,4,6.39,4
57,ðŸ‡§ðŸ‡¾,Varvara Kisel,2,0,0,0,0,170.19,2,86.06,2,92.9,2,78.3,2,6.42,20,3.6,12,3.53,4,Null,0,6.71,4,6.25,4,6.58,4,6.49,4,6.57,4
58,ðŸ‡ºðŸ‡¦,Anastasiia Shabotova,1,3,0,0,0,169,4,88.38,4,89.24,4,80.76,4,5.84,40,3.38,24,4.01,8,3.48,3,6.86,8,6.48,8,6.68,8,6.74,8,6.73,8
59,ðŸ‡¨ðŸ‡¾,Marilena Kitromilis,0,3,0,0,0,168.26,3,83.67,3,88.24,3,81.69,3,5.73,33,3,21,3.32,7,3.93,3,6.61,6,6.37,6,6.63,6,6.63,6,6.58,6
60,ðŸ‡°ðŸ‡·,Heesue Han,1,0,0,0,0,168.25,1,81.73,1,89.77,1,79.48,1,5.92,10,3.73,6,4.1,2,Null,0,6.77,2,6.44,2,6.69,2,6.66,2,6.64,2
61,ðŸ‡ºðŸ‡¸,Gabriella Izzo,0,2,0,1,0,167.93,3,76.77,3,82.23,3,86.7,3,4.64,30,4,18,3.74,6,4.3,3,7.24,6,7.01,6,7.2,6,7.28,6,7.31,6
62,ðŸ‡³ðŸ‡±,Lindsay Van Zundert,0,2,0,0,0,167.38,2,86.32,2,89.24,2,80.64,2,5.37,23,3.67,15,3.81,5,3.18,2,6.55,4,6.33,4,6.61,4,6.68,4,6.62,4
63,ðŸ‡ªðŸ‡ª,Eva Lotta Kiibus,0,3,1,1,0,167.14,5,79.15,5,83.11,5,85.03,5,5.05,50,3.4,30,4.2,10,3.79,5,7.02,10,6.81,10,7.02,10,7.2,10,7.23,10
64,ðŸ‡ºðŸ‡¸,Starr Andrews,0,2,1,1,0,165.81,4,78.34,4,80.94,4,85.87,4,4.67,40,3.75,24,3.91,8,3.9,4,7.24,8,7.08,8,7.16,8,7.33,8,7.29,8
65,ðŸ‡¨ðŸ‡¦,Gabrielle Daleman,0,2,0,1,0,165.41,3,81.12,3,80.11,3,86.64,3,4.54,30,3.79,18,3.81,6,4.4,3,7.37,6,7,6,7.08,6,7.36,6,7.31,6
66,ðŸ‡«ðŸ‡®,Emmi Peltonen,0,2,0,0,0,165.08,2,69.92,2,73.46,2,91.62,2,4.53,20,2.64,12,4,4,4.3,2,7.59,4,7.35,4,7.5,4,7.7,4,7.85,4
67,ðŸ‡«ðŸ‡®,Jenni Saarinen,0,2,0,1,0,164.63,3,72.67,3,77.56,3,89.4,3,4.46,30,3.37,18,4.42,6,3.92,3,7.48,6,7.39,6,7.38,6,7.62,6,7.66,6
68,ðŸ‡°ðŸ‡·,Ahsun Yun,2,0,0,0,0,163.74,2,80.48,2,88.95,2,75.79,2,6.03,20,3.45,12,3.97,4,Null,0,6.48,4,6.09,4,6.23,4,6.3,4,6.2,4
69,ðŸ‡®ðŸ‡¹,Lara Naki Gutmann,0,2,1,1,0,163.54,4,78.58,4,81.89,4,82.14,4,4.97,40,3.45,24,3.77,8,4,4,6.86,8,6.7,8,6.76,8,6.98,8,6.86,8
70,ðŸ‡¦ðŸ‡¹,Olga Mikutina,0,0,1,1,0,162.55,2,76.14,2,77.76,2,86.3,2,4.29,20,3.79,12,4.12,4,3.9,2,7.2,4,7.1,4,7.13,4,7.32,4,7.27,4
71,ðŸ‡¦ðŸ‡º,Kailani Craine,0,3,0,1,0,162.4,4,81.38,4,81.29,4,81.11,4,5.11,40,3.47,24,3.14,8,3.12,4,6.82,8,6.46,8,6.86,8,6.86,8,6.92,8
72,ðŸ‡¨ðŸ‡­,Yasmine Kimiko Yamada,0,1,0,1,0,162.28,2,80.73,2,84.38,2,78.91,2,5.48,20,3.05,12,3.76,4,3.78,2,6.64,4,6.28,4,6.62,4,6.6,4,6.6,4
73,ðŸ‡«ðŸ‡·,LÃ©a Serna,0,2,1,1,0,161.13,4,81.18,4,81.8,4,80.83,4,4.7,40,3.77,24,4.15,8,3.86,4,6.86,8,6.48,8,6.69,8,6.81,8,6.79,8
74,ðŸ‡¸ðŸ‡ª,Josefin TaljegÃ¥rd,0,3,0,1,0,159.48,4,72.84,4,76.31,4,83.42,4,4.08,40,3.65,24,4.62,8,4.4,4,6.76,8,6.66,8,7.06,8,7.09,8,7.24,8
75,ðŸ‡ºðŸ‡¸,Hanna Harrell,0,1,0,0,0,158.89,1,75.08,1,76.21,1,82.68,1,4.58,10,3.24,6,3.4,2,4.2,1,6.82,2,6.62,2,6.85,2,7,2,7.05,2
76,ðŸ‡¬ðŸ‡§,Natasha Mckay,0,3,0,1,0,157.52,4,73.52,4,77.8,4,81.22,4,4.46,40,3.44,24,4.31,8,3.88,4,6.66,8,6.5,8,6.76,8,6.79,8,6.98,8
77,ðŸ‡°ðŸ‡·,Siwoo Song,1,0,0,0,0,157.01,1,78.23,1,84.08,1,73.93,1,5.86,10,3.38,6,2.61,2,Null,0,6.16,2,6.1,2,6.16,2,6.25,2,6.12,2
78,ðŸ‡«ðŸ‡®,Oona Ounasvuori,0,3,0,0,0,155.86,3,75.79,3,77.36,3,79.16,3,4.63,33,3.3,21,3.33,7,3.63,3,6.62,6,6.25,6,6.52,6,6.61,6,6.64,6
79,ðŸ‡ºðŸ‡¸,Mia Kalin,2,0,0,0,0,155.48,2,88.56,2,83.56,2,72.92,2,5.87,20,3.03,12,3.33,4,Null,0,6.16,4,5.86,4,6.16,4,6.1,4,6.14,4
80,ðŸ‡°ðŸ‡·,Chaebin Hwang,1,0,0,0,0,155.32,1,78.79,1,82.86,1,73.46,1,5.58,10,3.51,6,3,2,Null,0,6.09,2,5.91,2,6.06,2,6.08,2,6.06,2
81,ðŸ‡¨ðŸ‡­,Kimmy Repond,1,0,0,0,0,155.06,1,87.57,1,84.64,1,71.42,1,5.76,10,3.37,6,3.42,2,Null,0,6,2,5.62,2,6.04,2,5.84,2,6,2
82,ðŸ‡¨ðŸ‡¦,Emily Bausback,0,2,1,0,0,154.5,3,77.92,3,78.27,3,77.89,3,4.67,30,3.51,18,3.65,6,3.17,3,6.7,6,6.28,6,6.54,6,6.57,6,6.51,6
83,ðŸ‡°ðŸ‡·,Siwon Lee,0,1,0,0,0,153.7,1,70.81,1,72.66,1,82.04,1,3.8,10,3.63,6,4.46,2,4,1,6.82,2,6.6,2,6.78,2,6.85,2,6.9,2
84,ðŸ‡­ðŸ‡º,Vivien Papp,2,0,0,0,0,153.23,2,76.79,2,78.26,2,75.48,2,4.97,20,3.52,12,3.73,4,Null,0,6.18,4,6.1,4,6.43,4,6.27,4,6.38,4
85,ðŸ‡«ðŸ‡·,MaÃ¯a Mazzara,0,2,0,0,1,152.68,2,83.94,2,80.9,2,74.78,2,4.89,23,3.02,15,2.63,5,3.5,2,6.21,4,5.8,4,5.82,4,6.01,4,6,4
86,ðŸ‡¨ðŸ‡¦,VÃ©ronik Mallet,0,0,0,1,0,151.87,1,70.43,1,74.58,1,78.29,1,4.21,10,3.82,6,3.16,2,3.21,1,6.68,2,6.32,2,6.56,2,6.59,2,6.64,2
87,ðŸ‡¨ðŸ‡¾,Emilea Zingas,0,3,0,0,0,151.67,3,71.81,3,72.28,3,80.05,3,4.44,30,2.8,18,3.62,6,3.86,3,6.62,6,6.39,6,6.62,6,6.77,6,6.88,6
88,ðŸ‡¹ðŸ‡¼,Tzu-Han Ting,0,1,0,1,0,151.39,2,81.56,2,79.12,2,74.26,2,4.6,20,3.62,12,3.86,4,3.64,2,6.23,4,5.96,4,6.25,4,6.23,4,6.24,4
89,ðŸ‡ªðŸ‡ª,Kristina Shkuleta-Gromova,0,3,0,0,0,151.34,3,76.07,3,76.64,3,74.69,3,4.52,30,3.51,18,3.39,6,3.63,3,6.18,6,5.91,6,6.19,6,6.24,6,6.2,6
90,ðŸ‡§ðŸ‡¬,Alexandra Feigin,0,1,0,1,0,151.04,2,76.98,2,75.16,2,76.38,2,4.52,20,3.3,12,3.42,4,3.32,2,6.49,4,6.22,4,6.44,4,6.52,4,6.43,4
91,ðŸ‡ºðŸ‡¸,Maryn Pierce,1,0,0,0,0,150.67,1,74.14,1,73.48,1,79.19,1,4.62,10,3.29,6,3.78,2,Null,0,6.62,2,6.36,2,6.58,2,6.6,2,6.8,2
92,ðŸ‡¨ðŸ‡­,Anna La Porta,1,0,0,0,0,150.25,1,78.04,1,78.58,1,72.67,1,5.28,10,3.32,6,2.95,2,Null,0,6.06,2,5.77,2,6.14,2,6.06,2,6.1,2
93,ðŸ‡¯ðŸ‡µ,Tomoe Kawabata,0,1,0,0,0,149.96,1,64.32,1,64.44,1,85.52,1,3.04,10,3.65,6,4.3,2,3.5,1,7.4,2,7.15,2,6.85,2,7.22,2,7.25,2
94,ðŸ‡¦ðŸ‡¹,Sophia Schaller,0,3,0,0,0,149.95,3,75.67,3,76.06,3,75.22,3,4.24,30,3.7,18,3.94,6,3.63,3,6.28,6,6.07,6,6.22,6,6.33,6,6.34,6
95,ðŸ‡ªðŸ‡ª,Amalia Zelenjak,1,0,0,0,0,149.32,1,79.61,1,81.15,1,69.17,1,5.25,10,3.78,6,2.99,2,Null,0,5.8,2,5.6,2,5.62,2,5.82,2,5.74,2
96,ðŸ‡¨ðŸ‡¿,Eliska Brezinova,0,2,0,1,0,149.15,3,77.1,3,73.51,3,76.97,3,4.27,30,3.43,18,3.45,6,3.33,3,6.57,6,6.25,6,6.38,6,6.62,6,6.45,6
97,ðŸ‡©ðŸ‡ª,Kristina Isaev,0,3,0,0,0,148.96,3,73.36,3,73.25,3,76.04,3,4.29,30,3.35,18,3.24,6,3.8,3,6.38,6,6.12,6,6.3,6,6.35,6,6.42,6
98,ðŸ‡¨ðŸ‡¦,Alison Schumacher,0,2,1,1,0,148.45,4,71.93,4,73.01,4,75.69,4,4.23,40,3.43,24,3.46,8,3.24,4,6.35,8,6.26,8,6.31,8,6.47,8,6.32,8
99,ðŸ‡®ðŸ‡¹,Lucrezia Beccari,0,0,1,0,0,148.29,1,74.46,1,70.63,1,80.66,1,4.02,10,3.42,6,3.4,2,3.14,1,6.8,2,6.7,2,6.6,2,6.86,2,6.82,2
100,ðŸ‡§ðŸ‡¾,Milana Ramashova,2,1,0,0,0,147.38,3,74.66,3,77.1,3,71.95,3,4.81,30,3.58,18,3.17,6,3.5,1,6.02,6,5.72,6,5.99,6,5.96,6,5.99,6
101,ðŸ‡³ðŸ‡¿,Jocelyn Hong,0,1,0,1,0,146.02,2,78.5,2,78.26,2,67.76,2,4.93,20,3.28,12,3.01,4,3.32,2,5.69,4,5.4,4,5.62,4,5.6,4,5.62,4
102,ðŸ‡­ðŸ‡º,JÃºlia LÃ¡ng,0,1,0,0,0,145.64,1,79.61,1,73.41,1,73.23,1,4.51,10,3.13,6,2.94,2,3.64,1,6.22,2,5.88,2,6.02,2,6.2,2,6.16,2
103,ðŸ‡¬ðŸ‡ª,Alina Urushadze,1,1,0,0,0,145.14,2,69.79,2,69.98,2,77.15,2,3.8,20,3.73,12,3.94,4,3.4,1,6.51,4,6.23,4,6.45,4,6.54,4,6.51,4
104,ðŸ‡ºðŸ‡¸,Josephine Lee,1,0,0,0,0,144.97,1,65.33,1,67.06,1,78.91,1,4.16,10,3.05,6,3.61,2,Null,0,6.68,2,6.5,2,6.48,2,6.72,2,6.66,2
105,ðŸ‡¨ðŸ‡­,Livia Kaiser,0,1,0,0,0,144.14,1,81.74,1,81.22,1,65.92,1,5.27,10,3.07,6,3.42,2,3.25,1,5.56,2,5.38,2,5.44,2,5.6,2,5.52,2
106,ðŸ‡«ðŸ‡·,Lola Ghozali,1,0,0,0,0,143.84,1,73.53,1,74.19,1,70.65,1,4.62,10,3.39,6,3.84,2,Null,0,6.05,2,5.78,2,5.86,2,5.96,2,5.8,2
107,ðŸ‡¨ðŸ‡¦,Sara-Maude Dupuis,1,0,0,0,0,143.54,1,73.75,1,73.6,1,70.94,1,4.79,10,3.31,6,2.93,2,Null,0,5.93,2,5.7,2,5.84,2,5.86,2,6,2
108,ðŸ‡¦ðŸ‡¹,Stefanie Pesendorfer,0,2,0,0,0,143.1,2,76.28,2,73.32,2,71.28,2,4.34,20,3.27,12,3.45,4,3.4,2,6.02,4,5.72,4,5.89,4,5.98,4,6,4
109,ðŸ‡¸ðŸ‡°,Nicole Rajicova,0,1,0,0,0,143,1,67.6,1,69.17,1,73.83,1,3.61,10,3.59,6,4.06,2,3.43,1,6.26,2,5.84,2,6.08,2,6.2,2,6.12,2
110,ðŸ‡®ðŸ‡±,Taylor Morris,0,3,0,0,0,142.78,3,75.4,3,72.71,3,71.41,3,4.23,33,3.29,21,3.28,7,3.47,3,6,6,5.65,6,5.84,6,5.92,6,5.89,6
111,ðŸ‡¨ðŸ‡¦,AudrÃ©anne Foster,1,0,0,0,0,142.46,1,69.96,1,70.86,1,71.6,1,4.49,10,3.34,6,2.95,2,Null,0,6.02,2,5.75,2,6.04,2,6.1,2,6.05,2
112,ðŸ‡¨ðŸ‡¦,Lia Pereira,1,0,0,0,0,142.43,1,68.83,1,69.93,1,75.5,1,4.24,10,3.57,6,3.06,2,Null,0,6.28,2,6.09,2,6.26,2,6.3,2,6.4,2
113,ðŸ‡·ðŸ‡´,Julia Sauter,0,2,0,0,0,141.66,2,68.99,2,71.8,2,69.87,2,4.2,20,3.48,12,2.69,4,3.5,2,5.95,4,5.58,4,5.86,4,5.85,4,5.89,4
114,ðŸ‡­ðŸ‡º,Regina Schermann,1,1,0,1,0,141,3,73.15,3,74.27,3,69.06,3,4.4,30,3.55,18,3.35,6,3.46,2,5.9,6,5.6,6,5.66,6,5.87,6,5.69,6
115,ðŸ‡µðŸ‡±,Noelle Streuli,2,0,0,0,0,140.76,2,77.36,2,75.82,2,66.93,2,4.47,20,3.93,12,3.76,4,Null,0,5.73,4,5.34,4,5.54,4,5.65,4,5.5,4
116,ðŸ‡«ðŸ‡®,Janna Jyrkinen,2,0,0,0,0,140.7,2,78.04,2,76.8,2,66.4,2,5,20,3.4,12,3.22,4,Null,0,5.7,4,5.44,4,5.39,4,5.62,4,5.48,4
117,ðŸ‡ªðŸ‡ª,Gerli LiinamÃ¤e,0,3,0,0,0,140.7,3,66.03,3,67.27,3,73.76,3,3.69,30,3.38,18,3.46,6,3.2,3,6.31,6,5.97,6,6.12,6,6.23,6,6.23,6
118,ðŸ‡¸ðŸ‡®,Dasa Grm,0,3,0,0,0,140.42,3,65.83,3,65.66,3,75.09,3,3.34,33,3.37,21,3.94,7,3.44,3,6.47,6,6.06,6,6.31,6,6.39,6,6.44,6
119,ðŸ‡®ðŸ‡¹,Ginevra Negrello,1,2,0,0,0,139.6,3,70.72,3,68.08,3,74.19,3,3.49,30,3.82,18,3.79,6,4,2,6.3,6,6.07,6,6.03,6,6.32,6,6.3,6
120,ðŸ‡ºðŸ‡¦,Anastasia Gozhva,0,1,0,0,0,139.53,1,70.88,1,72.41,1,68.12,1,4.15,10,3.44,6,3.6,2,3.1,1,6.02,2,5.5,2,5.58,2,5.65,2,5.6,2
121,ðŸ‡°ðŸ‡·,Boin Moon,1,0,0,0,0,139.11,1,66.61,1,67.87,1,74.24,1,3.92,10,3.68,6,3.29,2,Null,0,6.22,2,6.12,2,6.22,2,6.36,2,6.38,2
122,ðŸ‡«ðŸ‡®,Olivia Lisko,2,0,0,0,0,139.04,2,72.62,2,72.76,2,67.79,2,4.67,20,3.15,12,3.6,4,Null,0,5.64,4,5.46,4,5.64,4,5.66,4,5.65,4
123,ðŸ‡µðŸ‡­,Sofia Lexi Jacqueline Frank,0,2,0,1,0,138.71,3,74.4,3,71.19,3,69.85,3,4.38,30,3.09,18,2.98,6,2.94,3,5.82,6,5.64,6,5.8,6,5.92,6,5.98,6
124,ðŸ‡±ðŸ‡»,Nikola Fomchenkova,2,0,0,0,0,138.01,2,77.16,2,73.85,2,65.16,2,5.08,20,2.95,12,2.66,4,Null,0,5.68,4,5.35,4,5.38,4,5.43,4,5.3,4
125,ðŸ‡¬ðŸ‡§,Nina Povey,0,2,0,0,0,137.62,2,69.06,2,65.4,2,72.72,2,4.26,20,2.48,12,2.32,4,3.3,2,6.15,4,5.9,4,6.06,4,6.14,4,6.12,4
126,ðŸ‡«ðŸ‡®,Laura Karhunen,0,1,0,0,0,137.15,1,80.88,1,72.79,1,70.36,1,4.29,10,3.3,6,3.66,2,2.75,1,6.1,2,5.73,2,5.64,2,6.36,2,5.9,2
127,ðŸ‡³ðŸ‡±,Niki Wories,0,2,0,0,0,136.58,2,68.74,2,61.58,2,76.5,2,3.16,20,3.25,12,3.39,4,3.7,2,6.5,4,6.24,4,6.19,4,6.51,4,6.44,4
128,ðŸ‡¨ðŸ‡¿,Nikola Rychtarikova,0,1,0,0,0,136.5,1,72.47,1,68.34,1,69.16,1,3.99,10,3.13,6,2.81,2,4.1,1,5.8,2,5.58,2,5.7,2,5.82,2,5.8,2
129,ðŸ‡«ðŸ‡®,Linnea Ceder,0,1,0,0,1,136.38,1,64.25,1,63.62,1,72.76,1,3.74,13,3.02,9,2.39,3,3.9,1,6,2,5.69,2,5.85,2,5.98,2,5.98,2
130,ðŸ‡®ðŸ‡±,Mariia Seniuk,1,0,0,0,0,136.27,1,76.97,1,77.32,1,59.95,1,5.24,10,3.38,6,2.32,2,Null,0,5.3,2,4.89,2,5.06,2,5.06,2,5,2
131,ðŸ‡­ðŸ‡°,Joanna So,0,1,0,0,0,135.78,1,68.75,1,69.75,1,70.03,1,4.15,10,3,6,3.34,2,3.5,1,5.86,2,5.56,2,5.68,2,5.8,2,5.8,2
132,ðŸ‡±ðŸ‡¹,Daria Afinogenova,1,0,0,0,0,135.15,1,75,1,72.24,1,62.91,1,4.45,10,3.44,6,3.54,2,Null,0,5.36,2,4.9,2,5.32,2,5.23,2,5.18,2
133,ðŸ‡±ðŸ‡»,Anete Lace,0,2,0,0,0,134.64,2,66.46,2,66.24,2,69.89,2,4.04,23,2.95,15,3.02,5,3.45,2,6.05,4,5.68,4,5.82,4,5.98,4,5.86,4
134,ðŸ‡±ðŸ‡¹,Aleksandra Golovkina,0,2,0,1,0,134.25,3,66.38,3,64.63,3,71.62,3,3.32,30,3.49,18,3.54,6,3.4,3,6.06,6,5.76,6,5.84,6,6.05,6,5.99,6
135,ðŸ‡¦ðŸ‡º,Victoria Alcantara,0,2,0,1,0,133.89,3,72.55,3,70.18,3,65.37,3,4.03,30,3.33,18,3.24,6,3.43,3,5.45,6,5.32,6,5.47,6,5.51,6,5.44,6
136,ðŸ‡¬ðŸ‡§,Kristen Spours,0,2,0,0,0,133.03,2,70.42,2,66.47,2,67.56,2,4.07,20,2.97,12,2.35,4,3.3,2,5.8,4,5.49,4,5.66,4,5.75,4,5.76,4
137,ðŸ‡©ðŸ‡ª,Nargiz SÃ¼leymanova,2,1,0,0,1,132.45,3,77.52,3,69.6,3,64.85,3,4.33,33,3.35,21,2.57,7,3.4,1,5.62,6,5.25,6,5.37,6,5.48,6,5.41,6
138,ðŸ‡²ðŸ‡½,Andrea Montesinos CantÃº,0,1,0,1,0,132.44,2,61.68,2,63.88,2,69.06,2,3.31,20,3.49,12,3.22,4,3.4,2,5.83,4,5.48,4,5.82,4,5.74,4,5.81,4
139,ðŸ‡²ðŸ‡½,Eugenia Garza Martinez,0,1,0,1,0,132.01,2,65.42,2,65.16,2,67.34,2,3.51,20,3.43,12,3.06,4,3.36,2,5.71,4,5.41,4,5.67,4,5.64,4,5.73,4
140,ðŸ‡«ðŸ‡·,Lorine Schild,1,0,0,0,0,131.85,1,79.12,1,71.17,1,62.68,1,4.49,10,3.25,6,3.38,2,Null,0,5.42,2,5.06,2,5.16,2,5.22,2,5.21,2
141,ðŸ‡ºðŸ‡¦,Yelizaveta Babenko,0,1,0,0,0,131.51,1,67.75,1,63.11,1,68.4,1,3.88,10,2.62,6,2.78,2,3,1,5.72,2,5.52,2,5.72,2,5.75,2,5.7,2
142,ðŸ‡¨ðŸ‡¦,Catherine Carle,1,0,0,0,0,131.31,1,74.9,1,67.1,1,66.21,1,4.73,10,2.52,6,2.34,2,Null,0,5.79,2,5.15,2,5.62,2,5.52,2,5.56,2
143,ðŸ‡¨ðŸ‡¿,Barbora Vrankova,1,0,0,0,0,130.62,1,71.48,1,67.26,1,66.36,1,4.22,10,3.19,6,2.97,2,Null,0,5.7,2,5.43,2,5.56,2,5.62,2,5.57,2
144,ðŸ‡ºðŸ‡¦,Mariia Andriichuk,2,0,0,0,0,129.58,2,77.04,2,70.96,2,61.13,2,5.01,20,2.67,12,2.43,4,Null,0,5.43,4,5.07,4,5.01,4,5.15,4,5.04,4
145,ðŸ‡³ðŸ‡±,Julia Van Dijk,2,0,0,0,0,129.34,2,72.02,2,67.86,2,61.98,2,4.48,20,2.87,12,2.92,4,Null,0,5.3,4,5.03,4,5.12,4,5.17,4,5.13,4
146,ðŸ‡§ðŸ‡¬,Ivelina Baicheva,0,2,0,0,0,127.58,2,65.24,2,63.24,2,64.84,2,3.35,20,3.45,12,3.07,4,2.85,2,5.59,4,5.18,4,5.4,4,5.45,4,5.39,4
147,ðŸ‡¨ðŸ‡­,Sarina Joos,1,0,0,0,0,126.99,1,72.07,1,63.32,1,63.67,1,3.84,10,3.18,6,2.9,2,Null,0,5.28,2,5,2,5.26,2,5.27,2,5.44,2
148,ðŸ‡¨ðŸ‡¦,Justine Miclette,1,0,0,0,0,126.71,1,75.02,1,66.15,1,65.56,1,4.08,10,3.27,6,2.86,2,Null,0,5.62,2,5.36,2,5.38,2,5.48,2,5.5,2
149,ðŸ‡¦ðŸ‡¹,Emily Saari,2,0,0,0,0,126.64,2,68.92,2,65.9,2,61.75,2,4.31,20,3.1,12,2.11,4,Null,0,5.3,4,4.95,4,5.17,4,5.13,4,5.16,4
150,ðŸ‡¨ðŸ‡¿,Ellen Slavickova,1,1,0,0,0,126.4,2,77.2,2,68.04,2,61.86,2,4.59,20,2.45,12,2.89,4,3.4,1,5.4,4,4.92,4,5.2,4,5.08,4,5.07,4
151,ðŸ‡³ðŸ‡±,Dani Loonstra,1,0,0,0,0,125.76,1,59.07,1,62.39,1,63.37,1,3.72,10,3.28,6,2.73,2,Null,0,5.54,2,5.14,2,5.28,2,5.38,2,5.38,2
152,ðŸ‡µðŸ‡±,Elzbieta Gabryszak,0,1,0,0,0,125.59,1,68.28,1,61.31,1,67.28,1,3.39,10,3,6,3.24,2,2.9,1,5.75,2,5.42,2,5.62,2,5.6,2,5.78,2
153,ðŸ‡ªðŸ‡ª,Nataly Langerbaur,0,3,0,0,0,125.45,3,66.2,3,59.72,3,66.73,3,3.24,30,2.94,18,3.13,6,3.36,3,5.91,6,5.53,6,5.58,6,5.67,6,5.53,6
154,ðŸ‡©ðŸ‡ª,Nathalie Weinzierl,0,2,0,0,0,125.11,2,59.24,2,55.66,2,71.96,2,2.73,20,2.95,12,3.62,4,3.36,2,6.17,4,5.84,4,5.84,4,6.1,4,6.09,4
155,ðŸ‡³ðŸ‡´,Frida Berge,0,1,0,0,0,125.03,1,64.47,1,60.51,1,66.52,1,3.6,10,2.99,6,1.82,2,2.9,1,5.8,2,5.4,2,5.48,2,5.58,2,5.55,2
156,ðŸ‡·ðŸ‡¸,Antonina Dubinina,0,3,0,0,0,124.05,3,66.61,3,60.26,3,64.13,3,3.34,33,3.16,21,2.76,7,3.2,3,5.53,6,5.23,6,5.44,6,5.5,6,5.47,6
157,ðŸ‡¬ðŸ‡§,Elena Komova,1,1,0,0,0,123.84,2,67.24,2,65.06,2,60.28,2,3.86,20,3.02,12,3.37,4,3.2,1,5.14,4,4.74,4,4.95,4,5.02,4,4.99,4
158,ðŸ‡¸ðŸ‡®,Julija Lovrencic,2,0,0,0,0,121.62,2,62.95,2,63.68,2,59.94,2,3.63,20,3.53,12,3.09,4,Null,0,5.01,4,4.79,4,5.03,4,4.99,4,5.04,4
159,ðŸ‡¸ðŸ‡ª,Emelie Ling,1,1,0,0,0,121.46,2,54.1,2,56.11,2,66.84,2,2.82,20,3.2,12,3.52,4,3.4,1,5.71,4,5.42,4,5.42,4,5.66,4,5.78,4
160,ðŸ‡µðŸ‡±,Karolina Bialas,2,1,0,0,0,121.37,3,65.62,3,59.67,3,63.03,3,3.25,30,3.28,18,3.15,6,3.5,1,5.33,6,5.1,6,5.13,6,5.3,6,5.33,6
161,ðŸ‡­ðŸ‡º,Bernadett Szigeti,1,1,0,0,0,121.34,2,65.81,2,59.54,2,64.8,2,3.34,20,3.06,12,3.02,4,3.4,1,5.52,4,5.24,4,5.32,4,5.62,4,5.56,4
162,ðŸ‡§ðŸ‡¬,Maria Levushkina,1,1,0,0,0,121.18,2,60.56,2,58.04,2,65.14,2,3.12,20,3.1,12,3.26,4,3.4,1,5.65,4,5.28,4,5.3,4,5.58,4,5.47,4
163,ðŸ‡¸ðŸ‡°,Vanesa SelmekovÃ¡,2,0,0,0,0,120.91,2,64.51,2,63.24,2,58.66,2,4.03,20,2.86,12,2.9,4,Null,0,5.12,4,4.79,4,4.86,4,4.92,4,4.83,4
164,ðŸ‡¨ðŸ‡¿,Michaela Vrastiakova,1,0,0,0,0,120.74,1,63.25,1,62.98,1,57.76,1,4.07,10,2.84,6,2.66,2,Null,0,4.91,2,4.56,2,4.8,2,4.82,2,4.76,2
165,ðŸ‡«ðŸ‡·,Eve Dubecq,1,0,0,0,0,120.27,1,69.09,1,62.68,1,58.59,1,3.72,10,3.23,6,3.07,2,Null,0,5.28,2,4.88,2,4.82,2,5.05,2,4.75,2
166,ðŸ‡®ðŸ‡³,Tara Prasad,0,2,0,1,0,120.26,3,65.42,3,59.42,3,61.17,3,3.45,30,2.74,18,2.61,6,3.24,3,5.14,6,4.91,6,5.19,6,5.21,6,5.28,6
167,ðŸ‡®ðŸ‡¸,AldÃ­s Kara BergsdÃ³ttÃ­r,0,2,0,0,0,120.1,2,65.07,2,64.28,2,56.82,2,3.68,23,3.06,15,3.12,5,2.9,2,4.93,4,4.62,4,4.76,4,4.9,4,4.71,4
168,ðŸ‡©ðŸ‡ª,Aya Hatakawa,2,1,0,0,0,119.36,3,63.03,3,56.77,3,66.92,3,3.06,30,3.14,18,3.03,6,3.8,1,5.79,6,5.48,6,5.33,6,5.71,6,5.56,6
169,ðŸ‡§ðŸ‡¬,Chiara Hristova,2,0,0,0,0,118.48,2,64.55,2,62.14,2,57.33,2,4.21,20,2.53,12,2.46,4,Null,0,4.91,4,4.57,4,4.71,4,4.78,4,4.75,4
170,ðŸ‡¸ðŸ‡°,Alexandra Michaela FilcovÃ¡,2,1,0,0,0,118.1,3,67.37,3,63.1,3,55.34,3,4.12,33,2.76,21,2.33,7,3,1,4.95,6,4.51,6,4.74,6,4.76,6,4.69,6
171,ðŸ‡®ðŸ‡±,Viktoriia Iushchenkova,1,0,0,0,0,117.31,1,58.98,1,57.77,1,60.54,1,3.3,10,3.21,6,2.78,2,Null,0,5.26,2,4.74,2,5,2,5.02,2,5.04,2
172,ðŸ‡¬ðŸ‡§,Karly Robertson,0,1,0,0,0,117.31,1,62.3,1,58.71,1,65.6,1,2.79,10,3.56,6,3.16,2,3.08,1,5.88,2,5.44,2,5.31,2,5.86,2,5.56,2
173,ðŸ‡³ðŸ‡´,Linnea Kilsand,1,1,0,0,0,117.18,2,59.44,2,56.01,2,63.16,2,3.53,23,2.65,15,2.44,5,3,1,5.6,4,5.33,4,5.22,4,5.42,4,5.34,4
174,ðŸ‡©ðŸ‡°,Maia SÃ¸rensen,0,2,0,0,0,116.92,2,62.79,2,56.57,2,62.34,2,3.3,23,2.53,15,2.58,5,3.12,2,5.42,4,5.04,4,5.18,4,5.3,4,5.29,4
175,ðŸ‡³ðŸ‡±,Mikai Maria Van Ommeren,1,0,0,0,0,116.61,1,68.75,1,62.42,1,56.19,1,3.9,10,2.9,6,3.03,2,Null,0,4.94,2,4.48,2,4.62,2,4.7,2,4.57,2
176,ðŸ‡§ðŸ‡¬,Maria Manova,1,0,0,0,0,116.37,1,64.94,1,62.55,1,54.82,1,4.17,10,2.59,6,2.64,2,Null,0,4.69,2,4.29,2,4.6,2,4.6,2,4.52,2
177,ðŸ‡³ðŸ‡´,Mia Caroline Risa Gomez,1,0,0,0,0,116.2,1,63.27,1,62.13,1,56.07,1,3.76,10,3.25,6,2.51,2,Null,0,4.78,2,4.5,2,4.58,2,4.7,2,4.7,2
178,ðŸ‡¨ðŸ‡­,Shaline RÃ¼egger,0,1,0,0,0,115.55,1,63.23,1,57.83,1,59.72,1,3.43,10,2.65,6,2.26,2,3.1,1,5.3,2,4.88,2,5.15,2,4.95,2,4.95,2
179,ðŸ‡°ðŸ‡¿,Anna Levkovets,1,0,0,0,0,115.5,1,70.32,1,62.26,1,55.24,1,3.76,10,3.43,6,2.02,2,Null,0,4.63,2,4.48,2,4.56,2,4.66,2,4.5,2
180,ðŸ‡©ðŸ‡°,Anna-Flora Colmor Jepsen,1,0,0,0,0,115.3,1,55.83,1,55.43,1,59.87,1,3.11,10,2.99,6,3.17,2,Null,0,4.98,2,4.79,2,4.98,2,5.04,2,5.16,2
181,ðŸ‡¨ðŸ‡¾,Stefania Yakovleva,1,0,0,0,0,114.85,1,59.79,1,55.9,1,61.95,1,3.24,10,3.03,6,2.64,2,Null,0,5.2,2,5.04,2,5.04,2,5.27,2,5.16,2
182,ðŸ‡¦ðŸ‡¹,Dorotea Leitgeb,2,0,0,0,0,114.74,2,57.27,2,55.9,2,60.34,2,3.12,20,3.24,12,2.64,4,Null,0,5.12,4,4.86,4,5.02,4,5.07,4,5.13,4
183,ðŸ‡®ðŸ‡¹,Roberta Rodeghiero,0,1,0,0,0,114.49,1,56.97,1,52.17,1,64.32,1,2.99,10,2.39,6,2.44,2,3.1,1,5.72,2,5.25,2,5.4,2,5.52,2,5.58,2
184,ðŸ‡§ðŸ‡¬,Kristina Grigorova,0,2,0,0,0,114.3,2,66.8,2,59.36,2,57.43,2,3.4,20,2.96,12,2.66,4,2.28,2,5.22,4,4.68,4,4.82,4,5.01,4,4.74,4
185,ðŸ‡¨ðŸ‡¿,Olusa Gajdosova,0,1,0,0,0,114.13,1,62.61,1,54.13,1,61,1,2.98,10,2.74,6,2.55,2,2.8,1,5.18,2,4.75,2,5.18,2,5.05,2,5.12,2
186,ðŸ‡©ðŸ‡°,Catharina Victoria Petersen,1,0,0,0,0,113.76,1,57.71,1,54.32,1,61.44,1,3.22,10,2.68,6,3.02,2,Null,0,5.28,2,5.02,2,5.22,2,5.28,2,5.39,2
187,ðŸ‡¨ðŸ‡±,Yae-Mia Neira,0,3,0,0,0,113.43,3,60.86,3,55.88,3,58.89,3,2.83,30,3.09,18,2.82,6,3.37,3,4.95,6,4.68,6,4.95,6,5.02,6,5.06,6
188,ðŸ‡²ðŸ‡½,Regina Garcia De Leon Saab,1,0,0,0,0,113.36,1,55.41,1,55.64,1,58.72,1,3.05,10,3.22,6,2.94,2,Null,0,4.75,2,4.74,2,4.91,2,5,2,5,2
189,ðŸ‡¹ðŸ‡¼,Jenny Shyu,0,1,0,0,0,113.04,1,57.5,1,53.2,1,59.84,1,2.45,10,3.3,6,3.06,2,2.8,1,5.15,2,4.95,2,5.08,2,5.15,2,5.08,2
190,ðŸ‡±ðŸ‡¹,Selina Kaneda,1,0,0,0,0,112.56,1,52.07,1,52.15,1,63.41,1,2.99,10,2.59,6,3.36,2,Null,0,5.34,2,5.08,2,5.4,2,5.32,2,5.52,2
191,ðŸ‡±ðŸ‡»,Anastasija Konga,1,0,0,0,0,112.45,1,71.33,1,61.79,1,53.66,1,3.67,10,3.17,6,3.02,2,Null,0,4.8,2,4.38,2,4.38,2,4.56,2,4.5,2
192,ðŸ‡µðŸ‡±,Weronika Ferlin,2,0,0,0,0,112.32,2,63.73,2,61.1,2,52.72,2,3.69,20,3.1,12,2.82,4,Null,0,4.6,4,4.28,4,4.4,4,4.46,4,4.31,4
193,ðŸ‡µðŸ‡±,Natalia Lerka,0,1,0,0,0,112.06,1,57.92,1,53.86,1,59.2,1,2.99,10,2.58,6,2.82,2,2.8,1,5.22,2,4.82,2,4.82,2,5.02,2,4.92,2
194,ðŸ‡ºðŸ‡¿,Niginabonu Jamoliddinova,1,0,0,0,0,110.81,1,55.77,1,55.55,1,55.26,1,3.76,10,2.35,6,1.94,2,Null,0,4.82,2,4.41,2,4.64,2,4.61,2,4.75,2
195,ðŸ‡¹ðŸ‡·,Sinem Pekder,0,2,0,0,0,110.67,2,58.61,2,52.71,2,58.46,2,2.82,23,2.95,15,2.26,5,3.04,2,5.17,4,4.86,4,4.98,4,5.08,4,5.03,4
196,ðŸ‡¦ðŸ‡º,Vlada Vasiliev,1,0,0,0,0,110.48,1,68.59,1,60.79,1,53.69,1,3.68,10,3.3,6,2.13,2,Null,0,4.64,2,4.38,2,4.41,2,4.56,2,4.5,2
197,ðŸ‡¬ðŸ‡·,Alexandra Panagiota Manis,1,0,0,0,0,109.57,1,66.05,1,58.36,1,52.21,1,3.69,10,2.6,6,2.92,2,Null,0,4.71,2,4.12,2,4.32,2,4.4,2,4.32,2
198,ðŸ‡²ðŸ‡½,Alejandra Osuna Tirado,1,0,0,0,0,109.46,1,52.55,1,50.39,1,59.07,1,2.24,10,3.8,6,2.58,2,Null,0,4.82,2,4.61,2,5.04,2,4.92,2,5.24,2
199,ðŸ‡±ðŸ‡»,Sofja Stepcenko,2,0,0,0,0,108.1,2,65.36,2,57.18,2,54.92,2,3.67,20,2.61,12,2.42,4,Null,0,4.78,4,4.48,4,4.51,4,4.64,4,4.59,4
200,ðŸ‡¸ðŸ‡®,Manca Krmelj,1,0,0,0,0,108.08,1,66.91,1,56.68,1,54.4,1,3.31,10,3.02,6,2.73,2,Null,0,4.8,2,4.43,2,4.44,2,4.58,2,4.44,2
201,ðŸ‡®ðŸ‡¸,Julia Ros Vidarsdottir,2,0,0,0,0,105.94,2,53.68,2,50.45,2,57.5,2,2.53,20,3.13,12,3.16,4,Null,0,4.89,4,4.61,4,4.78,4,4.87,4,4.91,4
202,ðŸ‡­ðŸ‡º,Ivett TÃ³th,0,1,0,0,0,104.97,1,50.63,1,47.61,1,62.36,1,2.13,10,2.95,6,2.84,2,2.9,1,5.52,2,5.02,2,5.25,2,5.35,2,5.28,2
203,ðŸ‡¸ðŸ‡ª,Josefin Brovall,1,0,0,0,0,104.79,1,57.58,1,52.19,1,55.6,1,3.08,10,2.64,6,2.76,2,Null,0,4.88,2,4.48,2,4.66,2,4.66,2,4.64,2
204,ðŸ‡¹ðŸ‡¼,Yan-Yi Lin,1,0,0,0,0,104.34,1,53.23,1,54.33,1,50.01,1,3.25,10,3.06,6,1.74,2,Null,0,4.34,2,4.05,2,4.09,2,4.2,2,4,2
205,ðŸ‡¸ðŸ‡ª,Julia Brovall,1,0,0,0,0,103.5,1,55.13,1,49.74,1,55.76,1,2.73,10,2.76,6,2.94,2,Null,0,4.88,2,4.5,2,4.59,2,4.78,2,4.64,2
206,ðŸ‡­ðŸ‡°,Hiu Yau Chow,1,0,0,0,0,103.11,1,53.67,1,51.99,1,51.12,1,3.06,10,2.86,6,2.11,2,Null,0,4.48,2,4.1,2,4.27,2,4.4,2,4.33,2
207,ðŸ‡­ðŸ‡·,Hana Cvijanovic,1,1,0,0,0,102.86,2,52.79,2,49.07,2,56.29,2,2.25,20,3.12,12,3.14,4,3.2,1,4.79,4,4.56,4,4.77,4,4.78,4,4.89,4
208,ðŸ‡¹ðŸ‡·,Anna Deniz Ozdemir,1,0,0,0,0,102.74,1,51.43,1,47.08,1,55.66,1,2.36,10,2.83,6,3.26,2,Null,0,4.71,2,4.54,2,4.66,2,4.66,2,4.77,2
209,ðŸ‡ºðŸ‡¦,Anastasiia Fomchenkova,1,0,0,0,0,102.7,1,57.93,1,53.29,1,52.41,1,3.29,10,2.81,6,1.78,2,Null,0,4.68,2,4.1,2,4.48,2,4.54,2,4.41,2
210,ðŸ‡¦ðŸ‡¹,Jasmin Elsebaie,1,0,0,0,0,102.52,1,53.08,1,50.35,1,55.17,1,2.77,10,3.01,6,2.32,2,Null,0,4.56,2,4.5,2,4.62,2,4.62,2,4.64,2
211,ðŸ‡­ðŸ‡º,Lili Krizsanovszki,1,0,0,0,0,102.43,1,59.09,1,50.55,1,54.88,1,2.76,10,2.92,6,2.73,2,Null,0,4.84,2,4.43,2,4.54,2,4.66,2,4.71,2
212,ðŸ‡®ðŸ‡±,Ivetta Berkovich,1,0,0,0,0,102.33,1,52.44,1,46.2,1,57.13,1,2.26,10,2.9,6,3.1,2,Null,0,5.18,2,4.56,2,4.76,2,4.89,2,4.7,2
213,ðŸ‡¬ðŸ‡§,Arabella Sear-Watkins,1,0,0,0,0,101.92,1,56.47,1,51,1,51.92,1,2.92,10,2.89,6,2.26,2,Null,0,4.62,2,4.25,2,4.21,2,4.5,2,4.28,2
214,ðŸ‡·ðŸ‡´,Ana Sofia Beschea,1,0,0,0,0,101.38,1,56.89,1,51.38,1,52,1,2.89,10,3,6,2.22,2,Null,0,4.38,2,4.22,2,4.38,2,4.32,2,4.39,2
215,ðŸ‡²ðŸ‡½,Andrea Astrain Maynez,1,0,0,0,0,100.78,1,52.45,1,47.32,1,55.46,1,2.21,10,2.97,6,3.68,2,Null,0,4.84,2,4.42,2,4.43,2,4.8,2,4.78,2
216,ðŸ‡ºðŸ‡¦,Taisiia Spesivtseva,1,0,0,0,0,100.61,1,56.82,1,48.81,1,54.8,1,2.5,10,3.21,6,2.31,2,Null,0,4.62,2,4.38,2,4.6,2,4.58,2,4.67,2
217,ðŸ‡¹ðŸ‡·,Ceren Karas,1,0,0,0,0,100.59,1,51.89,1,48.59,1,54,1,2.63,10,2.91,6,2.42,2,Null,0,4.68,2,4.38,2,4.5,2,4.52,2,4.62,2
218,ðŸ‡°ðŸ‡¿,Bagdana Rakhishova,1,2,0,0,0,100.28,3,54.85,3,49.1,3,51.84,3,2.41,30,2.96,18,2.6,6,3.08,2,4.53,6,4.2,6,4.36,6,4.38,6,4.32,6
219,ðŸ‡¸ðŸ‡°,Ema Doboszova,1,0,0,0,0,99.8,1,61.08,1,51.12,1,51.68,1,2.69,10,3.06,6,2.92,2,Null,0,4.64,2,4.22,2,4.25,2,4.32,2,4.34,2
220,ðŸ‡­ðŸ‡·,Meri Marinac,1,0,0,0,0,99.51,1,50.1,1,46.28,1,56.23,1,2.86,10,2.36,6,1.77,2,Null,0,4.73,2,4.65,2,4.58,2,4.88,2,4.73,2
221,ðŸ‡±ðŸ‡¹,Marija Brejeva,1,0,0,0,0,98.38,1,53.55,1,44.35,1,54.03,1,3.04,10,1.71,6,1.82,2,Null,0,4.74,2,4.3,2,4.5,2,4.62,2,4.5,2
222,ðŸ‡ºðŸ‡¿,Amaliya Sulaymonova,1,0,0,0,0,98.2,1,46.84,1,45.99,1,52.21,1,2.47,10,2.84,6,2.12,2,Null,0,4.54,2,4.16,2,4.42,2,4.4,2,4.45,2
223,ðŸ‡©ðŸ‡°,Babeth Hansson-Ostergaard,1,0,0,0,0,97.82,1,56.85,1,48.21,1,54.61,1,2.47,10,3.11,6,2.43,2,Null,0,4.59,2,4.64,2,4.54,2,4.74,2,4.59,2
224,ðŸ‡±ðŸ‡º,Gemma Marshall,1,0,0,0,0,97.6,1,53,1,47.57,1,52.03,1,2.38,10,2.96,6,3.01,2,Null,0,4.44,2,4.2,2,4.34,2,4.26,2,4.34,2
225,ðŸ‡°ðŸ‡¿,Anastassiya Lobanova,0,1,0,0,0,96.58,1,46.4,1,42.26,1,56.32,1,2.37,10,1.9,6,2.16,2,2.8,1,5.2,2,4.6,2,4.7,2,4.82,2,4.62,2
226,ðŸ‡°ðŸ‡¿,Yasmin Tekik,0,1,0,0,0,96.07,1,47.78,1,40.71,1,61.36,1,1.75,10,2.53,6,2.35,2,3.3,1,5.6,2,5.15,2,4.92,2,5.22,2,5.12,2
227,ðŸ‡¦ðŸ‡¹,Paola Jurisic,1,0,0,0,0,95.83,1,55.97,1,48.71,1,48.12,1,2.99,10,2.53,6,1.82,2,Null,0,4.3,2,4,2,3.94,2,4.14,2,3.95,2
228,ðŸ‡µðŸ‡ª,Sorami Tanaka,2,0,0,0,0,94.48,2,50.98,2,49.52,2,44.97,2,2.72,20,3.04,12,2.04,4,Null,0,3.77,4,3.46,4,3.81,4,3.77,4,3.8,4
229,ðŸ‡¹ðŸ‡·,Yasemin Zeki,0,1,0,0,0,94.18,1,55.16,1,48.54,1,50.64,1,2.62,10,2.56,6,2.08,2,2.8,1,4.75,2,4.35,2,4.2,2,4.4,2,4.2,2
230,ðŸ‡¹ðŸ‡­,Apiksana Tangsatapornphan,1,0,0,0,0,92.97,1,45.08,1,43.28,1,51.69,1,2.56,10,2.4,6,1.64,2,Null,0,4.3,2,4,2,4.41,2,4.36,2,4.54,2
231,ðŸ‡¹ðŸ‡¼,Vera Hsiaowei Zhong,1,0,0,0,0,92.37,1,51.3,1,42.61,1,50.76,1,2.01,10,2.9,6,2.56,2,Null,0,4.52,2,4.17,2,4.21,2,4.38,2,4.21,2
232,ðŸ‡°ðŸ‡¬,Sofiia Shubina,1,0,0,0,0,91.92,1,43.73,1,42.97,1,49.95,1,2.28,10,2.62,6,2.22,2,Null,0,4.19,2,4.08,2,4.19,2,4.17,2,4.02,2
233,ðŸ‡¬ðŸ‡·,Dimitra Korri,0,1,0,0,0,91.89,1,49.46,1,43.12,1,50.77,1,1.68,10,2.93,6,2.56,2,3.64,1,4.29,2,4.09,2,4.16,2,4.38,2,4.34,2
234,ðŸ‡®ðŸ‡±,Elizabet Gervits,1,0,0,0,0,90.51,1,50.81,1,41.06,1,52.45,1,2.56,10,1.68,6,2.66,2,Null,0,4.71,2,4.23,2,4.32,2,4.56,2,4.5,2
235,ðŸ‡¹ðŸ‡­,Thita Lamsam,0,1,0,0,0,90.13,1,48.59,1,43.1,1,50.03,1,1.76,10,2.9,6,2.49,2,3.14,1,4.42,2,4.07,2,4.11,2,4.36,2,4.23,2
236,ðŸ‡«ðŸ‡·,Julie Froetscher,0,1,0,0,0,89.84,1,43.91,1,38.04,1,54.8,1,1.93,10,2.09,6,2.04,2,2.1,1,5.15,2,4.65,2,4.5,2,4.8,2,4.62,2
237,ðŸ‡µðŸ‡±,Laura Szczesna,1,0,0,0,0,87.41,1,47.7,1,41.74,1,48.67,1,2.49,10,2.05,6,2.24,2,Null,0,4.34,2,4.02,2,3.96,2,4.09,2,4.08,2
238,ðŸ‡¸ðŸ‡®,Klara Sekardi,1,0,0,0,0,86.41,1,47.86,1,41.9,1,47.51,1,2.17,10,2.77,6,1.79,2,Null,0,4.14,2,3.88,2,3.91,2,4.09,2,3.92,2
239,ðŸ‡±ðŸ‡®,Romana Kaiser,0,2,0,0,0,85.7,2,45.88,2,40.48,2,46.72,2,1.79,20,2.77,12,1.67,4,2.6,2,4.14,4,3.77,4,3.99,4,4,4,3.91,4
240,ðŸ‡µðŸ‡ª,Victoria Velarde,0,1,0,0,0,85.27,1,41.24,1,36.59,1,50.68,1,1.46,10,2.39,6,2.2,2,3.3,1,4.2,2,4,2,4.32,2,4.18,2,4.4,2
241,ðŸ‡®ðŸ‡¸,Julia Sylvia Gunnarsdottir,1,0,0,0,0,84.95,1,39.23,1,35.99,1,51.96,1,1.81,10,2.18,6,2.37,2,Null,0,4.46,2,4.18,2,4.16,2,4.4,2,4.43,2
242,ðŸ‡·ðŸ‡´,Tara Maria Ienciu,1,0,0,0,0,84.49,1,52.76,1,42.49,1,45,1,2.73,10,1.85,6,2.04,2,Null,0,4.1,2,3.54,2,3.7,2,3.84,2,3.62,2
243,ðŸ‡¦ðŸ‡·,Sophia Natalie Dayan,1,0,0,0,0,84.44,1,52.86,1,42.93,1,44.51,1,2.5,10,2.42,6,1.68,2,Null,0,4.04,2,3.62,2,3.66,2,3.94,2,3.88,2
244,ðŸ‡±ðŸ‡º,Ysaline Hibon,1,0,0,0,0,84.39,1,41.26,1,35.71,1,48.68,1,1.79,10,2.37,6,1.8,2,Null,0,3.9,2,3.75,2,4.04,2,4.14,2,4.25,2
245,ðŸ‡¦ðŸ‡©,Paula Margarido Pereira,2,0,0,0,0,84.38,2,42.3,2,39.14,2,45.74,2,2.48,20,1.85,12,1.63,4,Null,0,3.92,4,3.6,4,3.82,4,3.86,4,3.84,4
246,ðŸ‡·ðŸ‡¸,Ivona Kleut,1,0,0,0,0,82.51,1,41.01,1,37.25,1,47.26,1,2.17,10,1.98,6,1.83,2,Null,0,4.08,2,3.75,2,3.82,2,4.04,2,3.98,2
247,ðŸ‡®ðŸ‡ª,Sophia Tkacheva,1,0,0,0,0,81.07,1,41.28,1,36.54,1,45.53,1,1.57,10,2.66,6,2.43,2,Null,0,3.91,2,3.68,2,3.77,2,3.84,2,3.98,2
248,ðŸ‡²ðŸ‡³,Maral-Erdene Gansukh,0,2,0,0,0,80.04,2,37.33,2,32.84,2,47.7,2,1.07,20,2.36,12,2.48,4,2.95,2,4.12,4,3.85,4,3.94,4,4.11,4,4.16,4
249,ðŸ‡­ðŸ‡·,Nevia Ana Medic,1,0,0,0,0,80.04,1,42.33,1,37.02,1,44.02,1,2.41,9,2.02,6,1.63,2,Null,0,3.8,2,3.48,2,3.68,2,3.78,2,3.62,2
250,ðŸ‡²ðŸ‡¾,Abigail Liew,1,0,0,0,0,79.85,1,42.46,1,36.26,1,44.59,1,1.94,10,2.31,6,1.48,2,Null,0,4.07,2,3.6,2,3.66,2,3.88,2,3.62,2
251,ðŸ‡µðŸ‡­,Charmaine Skye Chua,1,0,0,0,0,79.7,1,36.72,1,31.69,1,49.01,1,1.3,10,2.52,6,1.81,2,Null,0,4.14,2,3.88,2,4.16,2,4.09,2,4.21,2
252,ðŸ‡¹ðŸ‡­,Atikarn Uersilapasarst,1,0,0,0,0,79.58,1,46.77,1,41.27,1,42.31,1,2.09,10,2.81,6,1.78,2,Null,0,3.69,2,3.38,2,3.56,2,3.67,2,3.62,2
253,ðŸ‡ªðŸ‡¸,Marian Millares,0,1,0,0,0,79.57,1,39.82,1,35.49,1,48.08,1,1.47,10,2.21,6,2.25,2,3,1,4.3,2,4.1,2,3.82,2,4.12,2,4.15,2
254,ðŸ‡¦ðŸ‡·,Michelle Dicicco,1,0,0,0,0,78.6,1,33.54,1,32.8,1,45.8,1,2,10,1.64,6,1.48,2,Null,0,3.88,2,3.59,2,3.88,2,3.86,2,3.94,2
255,ðŸ‡®ðŸ‡ª,Elizabeth Golding,1,0,0,0,0,77.74,1,40.75,1,34.36,1,46.38,1,1.56,10,2.58,6,1.63,2,Null,0,4.2,2,3.72,2,3.77,2,3.91,2,3.8,2
256,ðŸ‡°ðŸ‡¬,Aibike Esentaeva,1,0,0,0,0,77.55,1,35.59,1,32.07,1,47.48,1,1.5,10,2.34,6,1.51,2,Null,0,4.18,2,3.86,2,3.92,2,4.14,2,4,2
257,ðŸ‡·ðŸ‡¸,Danica Djordjevic,1,0,0,0,0,77.37,1,45.83,1,38.12,1,43.25,1,2.06,10,2.11,6,2.46,2,Null,0,3.84,2,3.59,2,3.62,2,3.7,2,3.7,2
258,ðŸ‡¹ðŸ‡¼,Tsai-En Chiang,1,0,0,0,0,76.61,1,44.81,1,40.07,1,37.54,1,2.16,10,2.59,6,1.46,2,Null,0,3.48,2,2.9,2,3.2,2,3.26,2,2.94,2
259,ðŸ‡µðŸ‡­,Skye Frances Patenia,1,0,0,0,0,76.51,1,38.49,1,33.95,1,44.56,1,1.46,10,2.73,6,1.5,2,Null,0,3.84,2,3.54,2,3.78,2,3.8,2,3.72,2
260,ðŸ‡¬ðŸ‡·,Alexandra Mintsidou,1,0,0,0,0,74.04,1,42.58,1,34.73,1,44.31,1,1.59,10,2.3,6,2.51,2,Null,0,4.09,2,3.61,2,3.59,2,3.84,2,3.57,2
261,ðŸ‡·ðŸ‡´,Luiza-Elena Ilie,1,0,0,0,0,73.91,1,34.62,1,30.59,1,47.32,1,1.15,10,2.58,6,1.78,2,Null,0,4.08,2,3.62,2,3.88,2,4.04,2,4.09,2
262,ðŸ‡²ðŸ‡°,Jana Kukovska,1,0,0,0,0,59.4,1,31.25,1,25,1,36.4,1,1.22,10,1.69,6,1.32,2,Null,0,3.14,2,2.98,2,3.04,2,3.12,2,3.12,2
263,ðŸ‡µðŸ‡ª,Nayra Rosalia Junco Metzger,0,1,0,0,0,50.11,1,19.13,1,14.91,1,38.2,1,0.63,10,0.54,6,1.23,2,2.9,1,3.2,2,3.1,2,3.18,2,3.22,2,3.22,2
264,ðŸ‡¦ðŸ‡²,Elen Ghazaryan,1,0,0,0,0,48.37,1,23.39,1,17.97,1,32.4,1,0.78,10,1.3,6,1.16,2,Null,0,2.8,2,2.6,2,2.72,2,2.76,2,2.77,2
265,ðŸ‡²ðŸ‡³,Misheel Otgonbaatar,1,0,0,0,1,44.89,1,27.42,1,18.69,1,32.2,1,0.86,13,0.95,9,1,3,Null,0,2.75,2,2.58,2,2.48,2,2.82,2,2.69,2
266,ðŸ‡®ðŸ‡³,Parrii Srohi,1,0,0,0,0,27.56,1,7.47,1,5.51,1,22.05,1,0.34,9,0.12,6,0.85,2,Null,0,1.78,2,1.72,2,1.86,2,1.78,2,1.91,2